0 0 0 0 0 540 540 540 540 540 540 540 540 540 540 540 540 540 540 540 540 540 540 540 540 540 540 540 540 540 540 540 540 540 540 540 540 540 540 540 540 0 0 0 0 0 0 0 0 0 
0 0 0 0 0 540 540 540 540 540 540 540 540 540 540 540 540 540 540 540 540 540 540 540 540 540 540 540 540 540 540 540 540 540 540 540 540 540 540 540 540 0 0 0 0 0 0 0 0 0 
0 0 0 0 0 540 540 540 540 540 540 540 540 540 540 540 540 540 540 540 540 540 540 540 540 540 540 540 540 540 540 540 540 540 540 540 540 540 540 540 540 0 0 0 0 0 0 0 0 0 
0 0 0 0 0 540 540 540 540 540 540 540 540 540 702 702 549 549 549 549 549 549 549 549 549 549 549 549 549 549 549 554 704 540 540 540 540 540 540 540 540 0 0 0 0 0 0 0 0 0 
0 0 0 0 0 540 540 540 540 540 540 540 540 540 541 541 730 730 730 730 730 730 730 731 730 730 730 730 735 737 730 539 539 540 540 540 540 540 540 540 540 0 0 0 0 0 0 0 0 0 
0 0 0 0 0 540 540 540 540 540 540 540 540 540 541 541 730 730 730 730 730 730 730 730 730 730 730 730 741 742 730 539 539 540 540 540 540 540 540 540 540 0 0 0 0 0 0 0 0 0 
0 0 0 0 0 540 540 540 540 540 540 540 540 540 541 541 730 730 730 730 730 730 730 730 730 730 730 730 730 730 730 539 539 540 540 540 540 540 540 540 540 0 0 0 0 0 0 0 0 0 
0 0 0 0 0 540 540 540 540 540 540 540 540 540 541 541 730 730 735 737 730 730 730 730 730 730 730 730 730 730 730 539 539 540 540 540 540 540 540 540 540 0 0 0 0 0 0 0 0 0 
0 0 0 0 0 540 540 540 540 540 540 540 540 540 541 541 730 730 741 742 730 730 730 730 730 730 730 730 730 730 730 539 539 540 540 540 540 540 540 540 540 0 0 0 0 0 0 0 0 0 
0 0 0 0 0 540 540 540 540 540 540 540 540 540 541 541 730 730 730 730 730 730 730 730 730 730 730 730 730 730 730 539 539 540 540 540 540 540 540 540 540 0 0 0 0 0 0 0 0 0 
0 0 0 0 0 540 540 540 540 540 540 540 540 540 541 541 730 730 730 730 730 730 730 730 730 730 730 730 730 730 730 539 539 540 540 540 540 540 540 540 540 0 0 0 0 0 0 0 0 0 
0 0 0 0 0 540 540 540 540 540 540 540 540 540 541 541 730 730 730 730 730 730 730 735 737 730 730 730 730 730 730 539 539 540 540 540 540 540 540 540 540 0 0 0 0 0 0 0 0 0 
0 0 0 0 0 540 540 540 540 540 540 540 540 540 541 541 730 730 730 730 730 730 730 741 742 730 730 730 730 730 730 539 539 540 540 540 540 540 540 540 540 0 0 0 0 0 0 0 0 0 
0 0 0 0 0 540 540 540 540 540 540 540 540 540 541 541 730 730 730 730 730 730 730 730 730 730 730 730 730 730 730 539 539 540 540 540 540 540 540 540 540 0 0 0 0 0 0 0 0 0 
0 0 0 0 0 540 540 540 540 540 540 540 540 540 541 541 730 730 730 730 730 730 730 730 730 730 730 730 730 730 730 539 539 540 540 540 540 540 540 540 540 0 0 0 0 0 0 0 0 0 
0 0 0 0 0 540 540 540 540 540 540 540 540 540 541 541 735 737 730 730 730 730 730 730 730 730 730 730 730 730 730 539 539 540 540 540 540 540 540 540 540 0 0 0 0 0 0 0 0 0 
0 0 0 0 0 540 540 540 540 540 540 540 540 540 541 541 741 742 730 730 730 730 730 730 730 730 730 730 730 730 730 539 539 540 540 540 540 540 540 540 540 0 0 0 0 0 0 0 0 0 
0 0 0 0 0 540 540 540 540 540 540 540 540 540 540 540 540 540 540 540 540 540 541 730 539 540 540 540 540 540 540 540 540 540 540 540 540 540 540 540 540 0 0 0 0 0 0 0 0 0 
0 0 0 0 0 540 540 540 540 540 540 540 540 540 540 540 540 540 540 540 540 540 541 730 539 540 540 540 540 540 540 540 540 540 540 540 540 540 540 540 540 0 0 0 0 0 0 0 0 0 
0 0 0 0 0 540 540 540 540 540 540 540 540 540 540 540 540 540 540 540 540 540 541 730 539 540 540 540 540 540 540 540 540 540 540 540 540 540 540 540 540 0 0 0 0 0 0 0 0 0 
0 0 0 0 0 540 540 540 540 540 540 540 540 540 540 540 540 540 540 540 540 540 541 730 539 540 540 540 540 540 540 540 540 540 540 540 540 540 540 540 540 0 0 0 0 0 0 0 0 0 
0 0 0 0 0 540 540 540 540 540 540 540 540 540 540 540 540 540 540 540 540 540 709 730 539 540 540 540 540 540 540 540 540 540 540 540 540 540 540 540 540 0 0 0 0 0 0 0 0 0 
0 0 0 0 0 540 540 540 540 540 540 540 540 540 540 540 540 537 537 540 540 538 708 730 706 539 540 540 540 540 540 540 540 540 540 540 540 540 540 540 540 0 0 0 0 0 0 0 0 0 
0 0 0 0 0 540 540 540 540 540 540 540 540 540 540 540 540 537 537 540 541 550 730 730 730 548 539 540 540 540 540 540 540 540 540 540 540 540 540 540 540 0 0 0 0 0 0 0 0 0 
0 0 0 0 0 540 540 540 540 540 540 540 540 540 540 540 540 537 537 541 541 902 902 730 902 902 539 539 540 540 540 540 540 540 540 540 540 540 540 540 540 0 0 0 0 0 0 0 0 0 
0 0 0 0 0 540 540 540 540 540 540 540 540 540 540 540 540 537 537 541 541 730 902 902 902 730 539 539 540 540 540 540 540 540 540 540 540 540 540 540 540 0 0 0 0 0 0 0 0 0 
0 0 0 0 0 540 540 540 540 540 540 540 540 540 540 540 540 537 537 541 541 902 730 902 730 902 539 539 540 540 540 540 540 540 540 540 540 540 540 540 540 0 0 0 0 0 0 0 0 0 
0 0 0 0 0 540 540 540 540 540 540 540 540 540 540 540 540 537 537 541 541 730 902 730 902 730 539 539 540 540 540 540 540 540 540 540 540 540 540 540 540 0 0 0 0 0 0 0 0 0 
0 0 0 0 0 540 540 540 540 540 540 540 540 540 540 540 540 537 537 541 541 730 730 730 730 730 539 539 540 540 540 540 540 540 540 540 540 540 540 540 540 0 0 0 0 0 0 0 0 0 
0 0 0 0 0 540 540 540 540 540 540 540 540 540 540 540 540 537 537 541 541 735 737 730 730 730 539 539 540 540 540 540 540 540 540 540 540 540 540 540 540 0 0 0 0 0 0 0 0 0 
0 0 0 0 0 540 540 540 540 540 540 540 540 540 540 540 540 540 540 541 541 741 742 731 730 730 554 554 540 540 540 540 540 540 540 540 540 540 540 540 540 0 0 0 0 0 0 0 0 0 
0 0 0 0 0 540 540 540 540 540 540 540 540 540 540 540 540 540 540 540 540 555 555 555 555 555 559 559 540 540 540 540 540 540 540 540 540 540 540 540 540 0 0 0 0 0 0 0 0 0 
0 0 0 0 0 540 540 540 540 540 540 540 540 540 540 540 540 540 540 540 540 540 540 540 540 540 540 540 540 540 540 540 540 540 540 540 540 540 540 540 540 0 0 0 0 0 0 0 0 0 
0 0 0 0 0 540 540 540 540 540 540 540 540 540 540 540 540 540 540 540 540 540 540 540 540 540 540 540 540 540 540 540 540 540 540 540 540 540 540 540 540 0 0 0 0 0 0 0 0 0 
0 0 0 0 0 540 540 540 540 540 540 540 540 540 540 540 540 540 540 540 540 540 540 540 540 540 540 540 540 540 540 540 540 540 540 540 540 540 540 540 540 0 0 0 0 0 0 0 0 0 
0 0 0 0 0 0 0 0 0 0 0 0 0 0 0 0 0 0 0 0 0 0 0 0 0 0 0 0 0 0 0 0 0 0 0 0 0 0 0 0 0 0 0 0 0 0 0 0 0 0 
0 0 0 0 0 0 0 0 0 0 0 0 0 0 0 0 0 0 0 0 0 0 0 0 0 0 0 0 0 0 0 0 0 0 0 0 0 0 0 0 0 0 0 0 0 0 0 0 0 0 
0 0 0 0 0 0 0 0 0 0 0 0 0 0 0 0 0 0 0 0 0 0 0 0 0 0 0 0 0 0 0 0 0 0 0 0 0 0 0 0 0 0 0 0 0 0 0 0 0 0 
0 0 0 0 0 0 0 0 0 0 0 0 0 0 0 0 0 0 0 0 0 0 0 0 0 0 0 0 0 0 0 0 0 0 0 0 0 0 0 0 0 0 0 0 0 0 0 0 0 0 
0 0 0 0 0 0 0 0 0 0 0 0 0 0 0 0 0 0 0 0 0 0 0 0 0 0 0 0 0 0 0 0 0 0 0 0 0 0 0 0 0 0 0 0 0 0 0 0 0 0 
0 0 0 0 0 0 0 0 0 0 0 0 0 0 0 0 0 0 0 0 0 0 0 0 0 0 0 0 0 0 0 0 0 0 0 0 0 0 0 0 0 0 0 0 0 0 0 0 0 0 
0 0 0 0 0 0 0 0 0 0 0 0 0 0 0 0 0 0 0 0 0 0 0 0 0 0 0 0 0 0 0 0 0 0 0 0 0 0 0 0 0 0 0 0 0 0 0 0 0 0 
0 0 0 0 0 0 0 0 0 0 0 0 0 0 0 0 0 0 0 0 0 0 0 0 0 0 0 0 0 0 0 0 0 0 0 0 0 0 0 0 0 0 0 0 0 0 0 0 0 0 
0 0 0 0 0 0 0 0 0 0 0 0 0 0 0 0 0 0 0 0 0 0 0 0 0 0 0 0 0 0 0 0 0 0 0 0 0 0 0 0 0 0 0 0 0 0 0 0 0 0 
0 0 0 0 0 0 0 0 0 0 0 0 0 0 0 0 0 0 0 0 0 0 0 0 0 0 0 0 0 0 0 0 0 0 0 0 0 0 0 0 0 0 0 0 0 0 0 0 0 0 
0 0 0 0 0 0 0 0 0 0 0 0 0 0 0 0 0 0 0 0 0 0 0 0 0 0 0 0 0 0 0 0 0 0 0 0 0 0 0 0 0 0 0 0 0 0 0 0 0 0 
0 0 0 0 0 0 0 0 0 0 0 0 0 0 0 0 0 0 0 0 0 0 0 0 0 0 0 0 0 0 0 0 0 0 0 0 0 0 0 0 0 0 0 0 0 0 0 0 0 0 
0 0 0 0 0 0 0 0 0 0 0 0 0 0 0 0 0 0 0 0 0 0 0 0 0 0 0 0 0 0 0 0 0 0 0 0 0 0 0 0 0 0 0 0 0 0 0 0 0 0 
0 0 0 0 0 0 0 0 0 0 0 0 0 0 0 0 0 0 0 0 0 0 0 0 0 0 0 0 0 0 0 0 0 0 0 0 0 0 0 0 0 0 0 0 0 0 0 0 0 0 
0 0 0 0 0 0 0 0 0 0 0 0 0 0 0 0 0 0 0 0 0 0 0 0 0 0 0 0 0 0 0 0 0 0 0 0 0 0 0 0 0 0 0 0 0 0 0 0 0 0 
