502 502 502 502 502 502 502 502 502 502 502 502 502 502 502 502 502 502 502 502 502 502 502 502 502 502 502 502 502 502 502 502 502 502 502 502 502 502 502 502 502 502 502 502 502 502 502 502 502 502 
502 502 502 502 502 502 502 502 502 502 502 502 502 502 502 502 502 502 502 502 502 502 502 502 502 502 502 502 502 502 502 502 502 502 502 502 502 502 502 502 502 502 502 502 502 502 502 502 502 502 
502 502 502 502 502 502 502 502 502 502 502 502 502 502 502 502 502 502 502 502 502 502 502 502 502 502 502 502 502 502 502 502 502 502 502 502 502 502 502 502 502 502 502 502 502 502 502 502 502 502 
502 502 502 502 502 502 502 502 502 502 502 502 502 502 502 502 502 502 502 502 502 502 502 502 502 502 502 502 502 502 502 502 502 502 502 502 502 502 502 502 502 502 502 502 502 502 502 502 502 502 
502 502 502 502 502 502 502 502 502 502 502 502 502 502 502 502 502 502 502 502 502 502 502 502 502 502 502 502 502 502 502 502 502 502 502 502 502 502 502 502 502 502 502 502 502 502 502 502 502 502 
502 502 502 502 502 502 502 502 502 502 502 502 502 502 502 502 502 502 502 502 502 502 502 502 502 502 502 502 502 502 502 502 502 502 502 502 502 502 502 502 502 502 502 502 502 502 502 502 502 502 
502 502 502 502 502 766 761 761 761 761 761 761 761 761 761 761 761 761 761 761 761 765 502 502 502 502 502 502 502 502 502 502 502 502 502 502 502 502 502 502 502 502 502 502 502 502 502 502 502 502 
502 502 502 502 502 767 686 746 747 746 747 746 747 746 747 746 747 746 747 746 747 754 760 502 502 502 502 502 502 502 502 502 502 502 502 502 502 502 502 502 502 502 502 502 502 502 502 502 502 502 
502 502 502 502 766 784 686 744 745 744 745 744 745 744 745 744 745 744 745 744 745 754 760 502 502 502 502 502 502 502 502 502 502 502 502 502 502 502 502 502 502 502 502 502 502 502 502 502 502 502 
502 502 502 502 767 746 747 743 736 743 736 748 736 719 718 719 718 719 718 743 736 754 760 502 502 502 502 502 502 502 502 502 502 502 502 502 502 502 502 502 502 502 502 502 502 502 502 502 502 502 
502 502 502 502 509 744 745 744 745 749 745 749 750 507 507 507 507 507 507 744 745 782 761 761 761 761 761 765 502 502 502 502 502 502 502 502 502 502 502 502 502 502 502 502 502 502 502 502 502 502 
502 502 502 502 509 743 736 743 736 719 718 719 718 751 70 71 72 73 74 748 736 746 747 746 747 746 747 763 760 760 502 502 502 502 502 502 502 502 502 502 502 502 502 502 502 502 502 502 502 502 
502 502 502 502 767 744 745 744 745 105 106 107 108 751 75 77 78 80 81 744 745 744 745 744 745 744 745 763 760 760 502 502 502 502 502 502 502 502 502 502 502 502 502 502 502 502 502 502 502 502 
502 502 502 502 767 748 736 748 736 121 122 123 120 751 84 85 87 89 603 748 736 748 736 748 736 748 736 763 760 760 502 502 502 502 502 502 502 502 502 502 502 502 502 502 502 502 502 502 502 502 
502 502 502 502 767 744 745 744 745 132 128 130 136 751 605 607 608 609 610 749 750 744 745 749 745 744 745 763 760 760 502 502 502 502 502 502 502 502 502 502 502 502 502 502 502 502 502 502 502 502 
502 502 502 502 767 748 736 748 736 137 140 144 142 1 94 95 96 97 98 719 718 719 718 719 718 719 718 782 761 761 765 502 502 502 502 502 502 502 502 502 502 502 502 502 502 502 502 502 502 502 
502 502 502 502 767 749 750 749 750 1 325 326 327 1 1 325 326 327 1 1 1 751 751 751 751 751 751 751 751 751 519 502 502 502 502 502 502 502 502 502 502 502 502 502 502 502 502 502 502 502 
502 502 502 502 518 748 736 748 736 751 344 345 347 384 384 344 345 347 384 384 384 138 138 138 138 384 138 138 138 751 519 502 502 502 502 502 502 502 502 502 502 502 502 502 502 502 502 502 502 502 
502 502 502 502 518 744 745 744 745 751 384 384 384 384 384 384 384 384 384 138 138 138 384 384 138 384 138 138 751 751 519 502 502 502 502 502 502 502 502 502 502 502 502 502 502 502 502 502 502 502 
502 502 502 502 518 719 718 719 718 751 261 261 261 261 138 261 138 261 261 261 261 261 261 261 261 261 138 138 751 751 782 761 761 761 761 761 761 761 765 502 502 502 502 502 502 502 502 502 502 502 
502 502 502 502 522 783 783 783 783 783 778 746 747 746 747 746 747 746 747 746 747 746 747 751 751 261 138 138 751 751 746 747 746 747 746 747 746 747 769 502 502 502 502 502 502 502 502 502 502 502 
502 502 502 502 760 760 760 760 760 760 762 366 367 744 745 744 745 744 745 744 745 744 745 751 751 261 138 138 751 751 744 745 744 745 744 745 744 745 782 761 761 761 761 761 765 502 502 502 502 502 
502 502 502 502 502 502 502 502 502 502 767 743 736 743 736 743 736 743 736 743 736 743 736 751 751 261 138 138 751 751 743 736 743 736 743 736 743 736 746 747 746 747 746 747 769 502 502 502 502 502 
502 502 502 502 502 502 502 502 502 502 762 744 745 744 745 744 745 744 745 744 745 744 745 751 751 261 138 138 751 751 749 750 749 750 749 750 749 750 744 745 744 745 744 745 769 502 502 502 502 502 
502 502 502 502 502 502 502 502 502 502 762 748 736 743 736 743 736 743 736 743 736 743 736 751 751 261 138 138 751 751 743 736 743 736 743 736 743 736 743 736 743 736 743 736 769 502 502 502 502 502 
502 502 502 502 502 502 502 502 502 502 762 744 745 744 745 744 745 744 745 744 745 744 745 751 751 751 751 751 751 751 744 745 744 745 744 745 744 745 744 745 744 745 744 745 769 502 502 502 502 502 
502 502 502 502 502 502 502 502 502 502 762 719 718 719 718 719 718 719 718 719 718 719 718 751 751 751 751 751 751 751 719 718 719 718 719 718 719 718 719 718 748 736 748 736 769 502 502 502 502 502 
502 502 502 502 502 502 502 502 502 502 522 778 563 507 507 507 507 507 507 507 507 507 507 751 751 751 751 751 751 751 507 507 507 507 507 507 507 507 507 563 749 745 749 745 519 502 502 502 502 502 
502 502 502 502 502 502 502 502 502 502 502 509 507 507 507 507 507 507 507 507 507 507 507 751 751 751 751 751 751 751 507 507 773 774 774 776 507 507 507 507 719 718 748 736 519 502 502 502 502 502 
502 502 502 502 502 502 502 502 502 502 502 509 507 507 507 507 507 507 507 507 507 507 507 751 751 751 751 751 751 751 507 507 775 760 760 781 507 507 507 507 507 507 749 750 519 502 502 502 502 502 
502 502 502 502 502 502 502 502 502 502 502 522 759 759 753 507 507 507 507 507 507 507 507 751 751 751 751 751 751 751 151 507 755 757 757 758 507 507 507 507 507 507 719 718 519 502 502 502 502 502 
502 502 502 502 502 502 502 502 502 502 502 502 502 502 517 507 507 507 507 507 507 507 507 751 751 751 751 751 751 751 1 507 507 507 507 507 507 507 507 507 507 507 507 507 519 502 502 502 502 502 
502 502 502 502 502 502 502 502 502 502 502 502 502 502 517 507 507 507 507 507 507 507 507 751 751 751 751 751 751 751 33 38 39 8 38 39 41 507 507 507 507 507 507 507 519 502 502 502 502 502 
502 502 502 502 502 502 502 502 502 502 502 502 502 502 517 507 507 507 507 507 507 507 151 751 751 751 751 751 751 751 42 43 49 8 48 7 50 507 507 507 507 507 507 507 519 502 502 502 502 502 
502 502 502 502 502 502 502 766 761 761 761 761 761 761 784 751 751 751 751 751 751 751 751 751 751 751 751 751 751 751 14 53 54 19 58 59 22 507 507 507 507 507 507 507 519 502 502 502 502 502 
502 502 502 502 502 502 502 518 751 751 751 751 751 751 751 751 751 751 751 751 751 751 751 751 751 751 751 751 751 751 23 62 26 96 29 63 31 507 507 507 507 507 507 507 519 502 502 502 502 502 
502 502 502 502 502 502 502 518 751 751 751 751 751 751 751 751 714 715 751 751 751 751 751 751 751 751 751 751 751 751 751 1 325 326 327 1 1 1 751 751 751 751 751 751 510 502 502 502 502 502 
502 502 502 502 502 502 502 518 751 751 751 751 751 751 751 751 721 722 751 751 751 751 751 751 751 751 751 751 751 751 751 751 344 345 347 751 751 751 751 751 751 751 751 751 510 502 502 502 502 502 
502 502 502 502 502 502 502 518 751 751 751 751 714 715 751 751 751 751 751 751 714 715 751 751 751 751 751 751 751 751 751 751 751 751 751 751 751 751 751 751 751 751 751 751 510 502 502 502 502 502 
502 502 502 502 502 502 502 518 751 751 751 751 721 722 751 751 751 751 751 751 721 722 751 751 751 751 751 751 751 751 751 751 751 751 751 751 751 751 751 751 751 751 777 783 521 502 502 502 502 502 
502 502 502 502 502 502 502 518 751 751 751 751 751 751 751 714 540 559 715 751 751 751 751 751 751 751 751 751 751 751 751 751 751 751 751 751 751 751 751 751 751 751 519 502 502 502 502 502 502 502 
502 502 502 502 502 502 502 518 751 751 751 751 751 751 751 536 540 540 538 751 751 751 751 751 751 751 751 751 751 751 751 751 751 751 751 751 751 751 751 751 751 751 519 502 502 502 502 502 502 502 
502 502 502 502 502 502 502 518 751 751 751 751 714 715 751 721 542 549 722 751 714 715 751 751 751 751 751 751 751 751 751 751 751 751 751 751 751 751 751 751 751 751 519 502 502 502 502 502 502 502 
502 502 502 502 502 502 502 518 751 751 751 751 721 722 751 1 751 1 751 751 721 722 751 751 751 751 751 751 751 751 751 751 751 751 751 777 759 759 759 759 759 759 521 502 502 502 502 502 502 502 
502 502 502 502 502 502 502 518 751 751 751 751 751 751 751 751 751 751 751 751 751 751 751 751 751 751 751 751 751 751 751 751 751 751 751 519 502 502 502 502 502 502 502 502 502 502 502 502 502 502 
502 502 502 502 502 502 502 522 759 778 751 751 751 751 751 751 714 715 751 751 751 751 751 751 751 751 751 751 751 751 751 751 751 751 751 763 502 502 502 502 502 502 502 502 502 502 502 502 502 502 
502 502 502 502 502 502 502 502 516 518 751 751 751 751 751 751 721 722 751 751 751 751 751 751 751 777 759 759 759 759 759 759 759 759 759 521 502 502 502 502 502 502 502 502 502 502 502 502 502 502 
502 502 502 502 502 502 502 502 516 518 751 751 751 751 751 751 751 751 751 751 751 751 751 777 759 521 502 502 502 502 502 502 502 502 502 502 502 502 502 502 502 502 502 502 502 502 502 502 502 502 
502 502 502 502 502 502 502 502 516 522 759 759 759 759 759 759 759 759 759 759 759 759 759 521 502 502 502 502 502 502 502 502 502 502 502 502 502 502 502 502 502 502 502 502 502 502 502 502 502 502 
502 502 502 502 502 502 502 502 516 516 516 516 516 516 516 516 516 516 516 516 516 516 516 502 502 502 502 502 502 502 502 502 502 502 502 502 502 502 502 502 502 502 502 502 502 502 502 502 502 502 
